11111111111
10P00C000E1
11111111111