11111111111
10P00CCC0E1
11111111111