111111111111111111111
100000111000000001111
1000001000C1000C11111
100P0E000001000001001
11000C010000011100001
111000C000C1111111011
111111111111111111111