111111111111111
100000111000E11
1000001000C1001
100P00000001001
11000C010000011
111000C000C1111
111111111111111