111111111111111
100000111000E11
1000001000C1001
1000C0000001001
11P000010000011
1110000000C1111
111111111111111