111111111111111111111
100000111000000001111
1000M01000C10M0C11111
100P000000010000010E1
11000C0M0000011100001
111000C000C1111111011
111111111111111111111