111111111111111
100000111000E11
1000001000C1001
100P00000001001
110000010000011
1110000000C1111
111111111111111