111111111111
100PMC0000E1
111111111111