1111111111111111111111111111111
1000000E01110000000000100000111
1000C00001100000011100000110111
1P0110110100001111111C111000111
100000000000C000000100000000111
10000X00C1000100001100010110111
1111111111111111111111111111111