1111111111
10001ECP01
10C001C0C1
1001101101
1111111111