1111111111111111111111111111111111111111111
1111000000000000000000000000000000110111011
11100000000000000000001111111000P0000011111
1111111110001100000000011111111100011111011
11100000000E1000001110000000000001100000111
1111111111111111111111111111111111111111111