111111111111
10000CE00011
111111111111