111111111111
100PMC000AE1
111111111111