11111111
1110000111
11110111
111111111