1111111111
10C01E1P01
1111111111