1111111111111
10P0000M000E1
1111111111111