111111111111
1000000E1111
10000000CC11
100000000011
111111111111