11111111111
1P000CM0011
11111111111