1111111111
1000000P01
1000C00001
1001101101
1111111111